11111111111111111111111111
11000E0000000000C010000011
1P000000000010010000000011
100000010000100C0000000011
10000C00000000000011111111
10C000100C000C000000000001
11000000000000001111111111
10000000000000000100000001
11111111111111111111111111
