1111111111111111111
11000000000C0000C01
1P000000C0000001111
1E000C0001000C00011
1111111111111111111
