1111111111111111111
11000E0000000000C01
1P00000000001001111
100000000000000C011
10000C0000000000001
10C000100C000C00001
1111111111111111111
