1111111111111111111
11000E0000000000C01
1P0000C000000001111
100000000100000C011
10000C0000000000001
10C000000C000C00001
1111111111111111111
