111111111111111111111
110000E0000C0000C01
1P000000C0000001111
10000C0001000C00011
100000000000000000111
100C000000C00000001
1111111111111111111
